width=9
height=6
111111111
111110111
111140131
120000101
111010001
111111111