width=7
height=7
1111111
1111311
1111011
1110011
1111011
1200041
1111111