width=7
height=5
1111111
1121111
1300041
1111011
1111111