width=7
height=7
1111111
1141111
1424111
1000101
1030001
1000111
1111111